Bærmeso - fordrukken kvinde
Douen las - dovenlars, dalrerøv
Drikke-bønnes - en mand som kan drikke andre under bordet
Fandens morgengave- en led kvinde
Dros - dæmon eller djævel
Bommerute - fordrukken so
Drukken-knægt - fordrukken mand
Generalhore - en luder
Dummerpande - tosse
Fjante - idiot
Lanke - luder, hore
Bardus - en tosse som andre slår, driller og mishandler “,mobbeoffer”
Fanting - idiot
Skidenso - beskidt kvinde
Kvindegek - én der render efter kvinder,
Drikke-so - fordrukken kvinde
Filke - luder, usædelig kvinde
Trippe - kvinde som er usædelig i hemmelighed
Horebuk - liderlig mand
Møddigtyr - beskidt, siden dreng/karl
Helvedes dørnagle - ondsindet kvinde
Fjove - idiot, vanvittig, tosse
Håndkone - kvinde, som ligger i med en gift mand
Bengær - ond og modbydelig kvinde
Bukkebede - en kastreret ged
Glom - nar
Kvindeskænder - voldsmænd, bølle, voldtægtsmand
Sokunte - “svinefisse”
Brændevinsmær - fordrukken kvinde
Sludøg - “beskidte svin” (om kvinde)
Dummerdos - tossehoved, idiot
Sute - so, svin
Ølsæk - fordrukken mand/kvinde
Skidenslatte - beskidt kvinde
Møgdyngetyr - beskidt knægt
Skandthore - en (kagstrøgen og derfor uærlig) luder
